10 25 0 1 8 24
# #######################
# ##      #     ###     #
# ## ###    ###   # ### #
# ####   ##  #  #   #####
#     ## #  # # ### #####
# # ####   #  #   # # ###
# # #    ## # # # # #   #
# # # ##      # #   # # #
#      # ###      #   #  
########## ##############