13 12 1 0 11 11
############
  ##########
# ##     ###
# ## ###   #
# ## #  # ##
# #  ## #  #
# # ##   # #
#   ### #  #
# # ### ## #
# #      # #
# # ###### #
# ###    #  
############