10 10 0 1 8 9
# ########
# ##     #
# ## ### #
# ####   #
#     ## #
# # #### #
# # #    #
# # # ## #
# #    #  
##########